BBBBBBBBBBBBB
BB         BB
B B       B B
B  B     B  B
B   B   B   B
B    B B    B
BBBBBBBBBBBBB