BBBBBBBBBBBBBBBBBBBBBBBBBB
BBBBBBBBBBBBBBBBBBBBBBBBBB
BBBBBBBBBBBBBBBBBBBBBBBBBB
BBBBBBBBBBBBBBBBBBBBBBBBBB
BBBBBBBBBBBBBBBBBBBBBBBBBB
BBBBBBBBBBBBBBBBBBBBBBBBBB
BBBBBBB   B       BBBBBBBB
BBBBBBB   B       BBBBBBBB
BBBBBBB   B    B  BBBBBBBB
BBBBBBB        BBBBBBBBBBB
BBBBBBB   B    B  BBBBBBBB
BBBBBBB   B       BBBBBBBB
BBBBBBB   B       BBBBBBBB
BBBBBBBBBBBBBBBBBBBBBBBBBB
BBBBBBBBBBBBBBBBBBBBBBBBBB
BBBBBBBBBBBBBBBBBBBBBBBBBB
BBBBBBBBBBBBBBBBBBBBBBBBBB
BBBBBBBBBBBBBBBBBBBBBBBBBB