BBBBBBBBBBBBB
B   B       B
B   B       B
B   B    B  B
B        BBBB
B   B    B  B
B   B       B
B   B       B
BBBBBBBBBBBBB